################################################################################
#                                                                              #
#               #                                                              #
#              #                                                               #
#             #                                                                #
#    #       #                                                                 #
#     #     #                                                                  #
#       #  #                                                                   #
#        #                                                                     #
#                                                                              #
#                                                                              #
#                                                                              #
#                                                                              #
#                                                                              #
#                                                                              #
#                                                                              #
#                                                                              #
#                                                                              #
#                                                                              #
#                                                                              #
#                                                                              #
#                                                                              #
#                                                                              #
################################################################################