################################################################################
#                                                                              #
#                                    ######################  #####  ###  ####  #
#              #                        #   #     #    #     #####  ###  #  #  #
#             #                      #    # ##  # #  ###  #  ##     ###  ####  #
#    #       #                       #  ##### # ####  # # #  ##     ###  #  #  #
#     #     #                        #  #     # #     #   #  #####  ###  #  #  #
#       #  #                         #    # ##    ###   ###  #####  ###  #  #  #
#        #                           #   ##    #   #      #                    #
#                                    ######################  ############  ##  #
#                                                            ##&&&&&&&&&&  ##  #
#                                    ######################  ##            ##  #
#                                    ######################  ##  &&&&&&&&&&##  #
#                                    ######################  ##  ############  #
#                                    #####    &  &    #####                    #
#  #&#&#&#                           #####  &      &  #####  ####### ## #####  #
#  &&&&&&&                           #####            #####  #&      ##    &#  #
#  #&#&#&#                                                   #& & &# ## #& &#  #
#  &&&&&&&                           &&&&&&&&&&&&&&&&&&&&&&  #& & &# ## #& &#  #
#  #&#&#&#                           &&&&&&&&&&&&&&&&&&&&&&  #& & &# ## #& &#  #
#  &&&&&&&                           &&&&&&&&&&&&&&&&&&&&&&  #&      ##    &#  #
#  #&#&#&#                           &&&&&&&&&&&&&&&&&&&&&&  ####### ## #####  #
#                                                                              #
################################################################################